XXXXXXXXXXXXX
X     X     X 
X XXX X X X X   
X X X X X X X 
XP  X   X X X
XXXXXXXXXEXXX